10,10
1,1
5,6

13,05,05,05,05,05,05,05,05,03
09,05,05,05,05,05,05,05,03,10
10,09,05,05,05,05,05,03,10,10
10,10,09,05,05,05,03,10,10,10
10,10,10,09,05,03,10,10,10,10
10,10,10,10,13,06,10,10,10,10
10,10,10,12,05,05,06,10,10,10
10,10,12,05,05,05,05,06,10,10
10,12,05,05,05,05,05,05,06,10
12,05,05,05,05,05,05,05,05,06

  1
 8 2
  4

+---+---+---+---+---+---+---+---+---+---+
|                                       |
+---+---+---+---+---+---+---+---+---+   +